0 0 3 0 0 0 0 0 0 0 0 0 0 3 6 6
0 3 2 0 0 0 0 0 0 0 0 0 0 2 3 6
0 2 0 0 0 0 0 0 0 0 0 0 0 0 2 6
0 3 0 0 0 0 0 0 0 0 0 0 0 0 3 6
3 2 0 0 0 0 0 0 0 0 0 0 0 0 2 3
2 0 0 0 0 0 0 0 0 0 0 0 0 0 0 2
3 0 0 0 0 0 0 0 0 0 0 0 0 0 0 3
2 0 0 0 0 0 0 0 0 0 0 0 0 0 0 2
3 0 0 0 0 0 0 0 0 0 0 0 0 0 0 3
2 0 0 0 0 0 0 0 0 0 0 0 0 0 0 2
3 3 3 3 3 3 3 3 3 3 3 3 3 3 3 3
2 2 2 2 2 2 2 2 2 2 2 2 2 2 2 2